,Wife,Alternating,Husband,Jointly,Total
Laundry,156,14,2,4,176
Main_meal,124,20,5,4,153
Dinner,77,11,7,13,108
Breakfeast,82,36,15,7,140
Tidying,53,11,1,57,122
Dishes,32,24,4,53,113
Shopping,33,23,9,55,120
Official,12,46,23,15,96
Driving,10,51,75,3,139
Finances,13,13,21,66,113
Insurance,8,1,53,77,139
Repairs,0,3,160,2,165
Holidays,0,1,6,153,160
